111111111111111111
101220000020000021
100010102210101021
101000002000002221
102210102010101021
101000002220000021
100022222010101001
101220000000000001
120010101000100001
111111111111111111